airplane=aeroplane
stroller=pram
automaker=carmaker
candy apple=toffee apple
checking account=current account
corrections officer=prison officer
cotton candy=candy floss
diapers=nappies
drapes=curtains
drunk driving=drink-driving
elevator=lift
emcee=compere
eraser=rubber
faucet=tap
ferris wheel=big wheel
fish sticks=fish fingers
flashlight=torch
freeway=motorway
turnpike=motorway
garbage=rubbish
garters=suspenders
gasoline=petrol
grippe=flu
knapsack=rucksack
moving van=removal van
movie=film
oatmeal=porridge
pacifier=dummy
pantyhose=tights
parking lot=car park
parking enforcement officer=traffic warden
pitcher=jug
at recess=during breaktime
galoshes=wellingtons
scallion=spring onion
sedan=saloon
sidewalk=pavement
bathroom sink=washbasin
skillet=frying-pan
slicker=mackintosh
streetcar=tram
sweater=jumper
thumbtack=drawing-pin
trash=rubbish
trash can=dustbin
trolley car=tram
trunk=boot
undershirt=vest
vacation=holiday
windshield=windscreen
zipper=zip
